..............................
.############################.
.#00000000000000000000000000#.
.#000000000000000000000000O0#.
.#00000000000000000000000000#.
.#00000000000000000000000000#.
.#00000000000000000000000000#.
.#00000000000000000000000000#.
.#00000000000000000000000000#.
.#00000000000000000000000000#.
.#00000000000000000000000000##
.#00000000000000000000000000|0
.#00000000000000000000000000|0
.#00000000000000000000000000##
.#00000000000000000000000000#.
.#00000000000000000000000000#.
.#00000000000000000000000000#.
.#00000000000000000000000000#.
.############################.
..............................