..............................
.############################.
.#0000000000000000000000000O#.
.#00000000000000000000000000#.
.#00#######################|#.
.#00000000000000000000000000#.
.#########################00#.
.#00000000000000000000000000#.
.#00#######################|#.
.#00000000000000000000000000#.
.#########################00##
.#00000000000000000000000000|0
.#00000000000000000000000000|0
.#00##########################
.#00000000000000000000000000#.
#########################000#.
0000000000000000000000000000#.
0000000000000000000000000000#.
#############################.
..............................
