..............................
.############################.
.#rl00000000000000000000000o#.
.#ll000000000000000000000000#.
.#00000000000000000000000000#.
.#00######RR#################.
.#00000000000q0q0q0000000000#.
.#########RR##############00#.
.#00000000000q0q0q0000000000#.
.#00######RR#################.
.#0000000000000000000000000B##
.#0000000000000000000000000B|0
.#0000000000000000000000000B|0
.#0000000000000000000000000B##
.#########RR#############GG##.
##0000000000000000000000000g#.
000000000000000RRR0000000000#.
000000000000000RbR000000000O#.
#############################.
..............................
